Angel=Ангел
Smile=Улыбка
Sad=Грустно
Wink=Подмигивать
Blum=Язык
Cool=Кул
Biggrin=Широкая улыбка
Blush=Стыдно
Shock=Шок
Kiss=Поцелуй
Cry=Плакать
Secret=Секрет
Aggressive=Агрессивный
Fool=Дурак
Beee=Бе-е...
Jokingly=Шутка
Diablo=Дьявол
Music=Музыка
Bad=Плохо
Boredom=Тоскливо
Stop=Стоп
Rose=Цветок
Good=Хорошо
Drinks=Выпивка
Man_in_love=Влюблённый
Bomb=Бомба
Wacko=Придурок
Mamba=Мамба
Sorry=Извиняюсь
Clapping=Аплодисменты
Rofl=Катаюсь по полу от смеха
Pardon=Пардон
No=Нет
Crazy=Сумасшедший
Don't_know=Не знаю
Dance=Танец
Yahoo=Йяху-у-у!
Happy=Счастливый
Heart=Сердце
Laugh=Смех
LOL=Лопну от смеха
Mad=Сумасшедший
Shout=Кричать
Black_eye=Синяк
Pleasantry=Любезность